1111111111111111
1000000000000001
1000000000000001
1000000000000001
1000000000000001
1000000000000001
1000000000000001
1000000000000001
1000002222000001
1000002222000001
1000002222000001
1111111111111111
